%%%%%%%%%%%%%%%%%%%%%%%%%%%%%%%%%%%%%
%       % % %                     % %
% %%%%%%% % %%% % %%% %%% %%%%%%% % %
%       %       % %     %     % %   %
%%%%% %%%%% %%% % % % %%% %%%%% % %%%
%   % % % %   % % % %   % %   % %   %
% %%% % % % %%% %%%%% %%%     % %%% %
%       %     %   %   %     % % %   %
%%% %%%%%%%%% %%%%%%% %%% %%% % % % %
%             %       % %   %     % %
% % %%%%% % %%% % % %%% % %%% %%% % %
% % %     % % % % %     %   % % % % %
% % % %%%%%%% % %%%%%%%%% %%% % %%% %
% % % %     %   %     %     %   %   %
%%% %%% % %%%%% %%%%% %%% %%% %%%%% %
%     % % %     % %     % %   % % % %
% % % % % %%% %%% %%% %%% % % % % % %
% % % % %                 % % %     %
%%% %%%%%%% % % %%%%% %%% % %%% %%%%%
%       % % % %     %   %     % %   %
%%%%% % % %%%%%%%%% %%%%%%%%%%% % %%%
%   % %           % %     %   % %   %
% %%% %%%%% %%%%%%%%% %%%%% % % %%% %
% %   %      %        %     %       %
% % % %%%%% %%% % % % % %%%%%%%%%%%%%
% % %   %     % % % %           % % %
% % %%% %%% % % % %%%%%%%%% %%% % % %
% %   % %   % % %   % %   % % %     %
% %%% %%% %%%%% %%% % % %%%%% % %%%%%
%       %   %     % %     %   % %   %
%%% % %%%%% %%%%% %%% %%% % %%% % % %
% % % % % % % %     % %   % %     % %
% % %%% % % % % %%%%%%%%% % % %%%%% %
%   %   %   %       %%        %     %
% % % % %%% %%% %%%%%%% %%% %%% %%% %
%.%   %       %           %        P%
%%%%%%%%%%%%%%%%%%%%%%%%%%%%%%%%%%%%%
