%%%%%%%%%%%%%%%%%%%%%%%%%%%%%%%%%%%%%
%%%%%%%%%                         %%%
%%%%%%%   %%%%% % %%% %%% %%%%%%% %%%
%%%%%   %       % %     %     % % %%%
%%%%% %%%%% %%% % % % %%% %%%%% % %%%
%%%%% % % %   % % % %   % %     %   %
%%%%% % % % %%% %%%%% %%% % %%% % % %
%%%     %       %%%%% %%%   % % % % %
%%% %%%%%%%%% %%%%%%% %%% %%% % % % %
%             %       % %   %     % %
%%% %%%%%%%%%%% % % %%% % %%% %%% % %
%%% %%%%%%%%%%% % %     %   % % % % %
%%% %%%%%%%%%%% %%%%%%%%% %%% % %%% %
%%% %%%%%%%%%%%       %%%   %   %   %
%%% %%%%%%%%%%% %%%%% %%% %%% %%%%% %
%%% %%%%%               % %%  % % % %
%%% %%%%%  % %%% %%%  %   % % % % % %
%%% %%%%% %% % % % % %%  %% % %   % %
%%% %%%%%  % %%% %%%  % %%% %%% %%% %
%     %%%% %   %   %  % %     % %   %
% %%% %%%% % %%% %%%  % %%%%%%% %% %%
%   % %%%%                %   % %   %
% %%% %%%%%%%%%%%%%%%%%%%%% % % %%% %
% %   %%%%                  %       %
% % % %%%%% %%% % % % % %%%%%%%%%%% %
% % %   %     % % % %       %   % % %
% % %%% %%% % % % %%%%%%%%% %%% % % %
% %   % %   % % %   % %   % % %     %
% %%% %%% %%% % %%% % % %%%%% % %%%%%
%   %   %   %     %       %   % %   %
%%% % % %%% %%%%% %%% %%% % %%% % %%%
%%% % % % % % %     % %   % %   % % %
%%% %%% % % % % %%%%%%%%% % % % % % %
%   %%  %                     %     %
% % %  %%%%%%%%%%%%%%%%%%%% %%% %%% %
%.%   %%%%%%%%%%%%%%%%%%%%%      P  %
%%%%%%%%%%%%%%%%%%%%%%%%%%%%%%%%%%%%%
