%%%%%%%%%%%%%%%%%%%%%%%%%%%%%%%%%%%%%%%%%%%%%%%
%       % % %           %         %   %%%%    %
% %%%%%%% % %%% % %%% %%% %%%%%%% % % %%%  %% %
%       %       % %     %     % %   % %%  %%% %
%%%%% %%%%% %%% % % % %%% %%%%% % %%% %  %%%% %
%   % % % %   % % % %   % %   % %   % %% %%%% %
% %%% % % % %%% %%%%% %%% % %%% %%% % %% %%%% %
%       %     %   %         % % %   %       % %
%%% %%%%%%%%% %%%%%%% %%% %%% % % % %%%% %%%% %
%             %       % %   %     % %      %% %
% % %%%%% % %%% % % %%% % %%% %%% % %  %%%%%% %
% % %     % % % % %     %   % % % % %      %% %
% % % %%%%%%% % %%%%%%%%% %%% % %%% %%%%% %%% %
% % % %     %   %     %     %   %   %      %% %
%%% %%% % %%%%% %%%%% %%% %%% %%%%% % %%%%%%% %
%     % % %     % %     % %   % % % %      %% %
% % % % % %%% %%% %%% %%% % % % % % %%%%%% %% %
% % % % %                 % % %            %% %
%%% %%%%%%% % % %%%%% %%% % %%% %%%%% %%%%%%% %
%       % % % %     %   %     % %   %      %% %
%%%%% % % %%%%%%%%% %%%%%%%%%%% % %%%%%%%%%%% %
%   % %           % %     %   % %   %         %
% %%% %%%%% %%%%%%%%% %%%%% % % %%% % %%%%%%% %
% %   %      %        %     %                 %
% % % %%%%% %%% % % % % %%%%%%%%%%%%%%%%%%%%% %
% % %   %     % % % %       %   % % %         %
% % %%% %%% % % % %%%%%%%%% %%% % % % %%%%%%%%%
% %   % %   % % %   % %   % % %     % %%      %
% %%% %%% %%%%% %%% % % %%%%% % %%%%% %% % %% %
%       %         % %     %   % %   % %% % %% %
%%% % %%%%% %%%%% %%% %%% % %%% % %%% %% % %% %
% % % % % % % %     % %   % %   % % %    % %% %
% % %%% % % % % %%%%%%%%% % % % % % %%%% % %% %
%   %   %   %                 %     %    % %% %
% % % % %%% %%% %%%%%%% %%% %%% %%% % %%%% %% %
%.% % %       %   %       %   % %     %%%%   P%
%%%%%%%%%%%%%%%%%%%%%%%%%%%%%%%%%%%%%%%%%%%%%%%
