%%%%%%%%
%     P%
% % %% %
%     %%
%% %%  %
%    % %
%.     %
%%%%%%%%
