%%%%%%%%%%%%%%%%%%%%%%%%%%%%%%%%%%%%
%                                 P%
% %%%%%%%%%%%%%%%%%%%%%%% %%%%%%%% %
% %%   %   %      %%%%%%%   %%     %
% %% % % % % %%%% %%%%%%%%% %% %%%%%
% %% % % % %             %% %%     %
% %% % % % % % %%%%  %%%    %%%%%% %
% %  % % %   %    %% %%%%%%%%      %
% %% % % %%%%%%%% %%          %%%%%%
% %% %   %%       %%%%%%%%  %%%%%%%%
%    %%%%%% %%%%%%%%%%%%    %%%%   %
%%%%%%      %       %%%% %%%%      %
%      %%%%%% %%%%%%%    %%%%% %%%%%
% %%%%%%      %       %%%%%%%% %%%%%
% %%%%%%%%%%%%      %%%%%%%%%%     %
%            %%%%%%     %%%%%%%%%% %
%. %%%%%%%%                        %
%%%%%%%%%%%%%%%%%%%%%%%%%%%%%%%%%%%%
