%%%%%%%%%
%   %% P%
%%%    %%
%   %% %%
% %%%   %
%   %%% %
%%%   % %
%.  %   %
%%%%%%%%%
