%%%%%%%%%%%%%%%%%%%%%%
%          %        P%
%  %%%%%%      %%%%  %
%%      %%%%%%%%     %
%%%% %%%%%%%%%%%%%%% %
%    %%%      %%     %
% %%  %% %%%% %% %%%%%
% %%          %   %%%%
%    %% %%%%%     %%%%
%%%%%%% %%    %%% %%%%
%.         %%     %%%%
%%%%%%%%%%%%%%%%%%%%%%
