%%%%%%%%%%%%%%%%%%%%%%
%          P         %
%  %% %% %%%% %%%%%% %
%% %% %% %%%% %%%%%% %
%% %%    %%%% %%%%%% %
%    %%%      %%     %
% %% %%% %%%% %% %%%%%
% %%          %% %%%%%
%    %% %%%%%     %%%%
%%%%%%% %%    %%% %%%%
%.         %%     %%%%
%%%%%%%%%%%%%%%%%%%%%%
