%%%%%%%%%%%%%%%%%%%%%%
%          P         %
%  %% %% %%%% %%%%%  %
%% %% %% %%%% %%%%%  %
%%  %     %%%  %%%%% %
%    %%%      %%     %
% %%  %% %%%% %% %%%%%
% %%          %   %%%%
%    %% %%%%%     %%%%
%%%%%%% %%    %%% %%%%
%.         %%     %%%%
%%%%%%%%%%%%%%%%%%%%%%
